############################
#............##............#
#.####.#####.##.#####.####.#
#*####.#####.##.#####.####*#
#.####.#####.##.#####.####.#
#..........................#
#.####.##.########.##.####.#
#.####.##.########.##.####.#
#......##....##....##......#
######.##### ## #####.######
#    #.##### ## #####.#    #
#    #.##          ##.#    #
#    #.## ###  ### ##.#    #
######.## #      # ##.########
      .     GGGG   ##   .     #
######.## #      # ##.########
#    #.## ######## ##.#    #
#    #.##          ##.#    #
######.## ######## ##.######
#............##............#
#.####.#####.##.#####.####.#
#.####.#####.##.#####.####.#
#*..##.....P..........##..*#
###.##.##.########.##.##.###
###.##.##.########.##.##.###
#......##....##....##......#
#.##########.##.##########.#
#..........................#
############################

